13 58 59 59 60 37 37 37 12 18 19 13 12 13 12 13 12 13 12 13 12 13 12 13 12 13 12 13 12 13 12 13 12 13 12 18 19 13 12 13
15 61 2 2 62 39 39 39 14 19 13 6 0 0 28 29 29 29 30 0 0 21 21 21 0 0 7 0 0 0 0 0 6 6 6 12 13 70 60 5
13 61 2 2 66 60 5 5 12 18 15 6 0 0 31 32 32 32 33 0 0 1 38 1 0 0 0 0 0 0 0 0 0 0 0 6 14 15 67 59
15 61 2 2 2 62 0 7 14 19 13 6 6 0 39 38 39 38 39 0 7 4 0 4 0 0 0 0 0 14 15 0 0 0 0 6 12 13 76 74
13 63 64 64 64 65 0 0 12 18 15 70 60 6 7 3 3 3 3 3 3 3 4 0 7 0 0 0 0 12 13 0 0 0 0 14 15 5 73 77
15 0 0 7 0 0 0 0 14 19 13 0 62 6 6 6 6 0 7 0 0 3 0 0 58 72 0 7 0 14 15 0 0 0 0 12 13 0 5 5
18 15 0 0 0 0 0 0 12 18 15 0 67 59 59 59 59 71 78 69 59 79 59 59 68 0 0 0 0 12 13 0 0 0 0 14 15 0 0 5
19 13 0 0 0 0 0 0 14 19 13 0 73 74 74 74 74 74 74 74 74 79 74 74 75 0 0 0 0 14 15 0 0 0 0 12 13 5 5 5
13 0 0 0 0 0 0 0 12 18 15 0 24 24 24 24 24 24 24 0 0 3 0 0 0 0 7 0 0 12 13 0 0 25 6 4 0 5 5 5
15 0 14 15 0 7 0 0 0 12 13 0 24 24 7 7 7 24 24 0 0 3 0 6 6 6 0 3 3 3 3 3 3 3 6 4 3 3 3 3
13 0 12 13 0 0 0 0 0 14 15 0 24 7 24 80 24 7 24 0 0 3 6 28 29 30 6 3 0 14 15 0 0 6 6 14 15 0 7 5
15 0 0 0 0 14 15 0 0 12 13 0 24 7 24 81 24 7 24 0 0 3 6 34 35 36 6 3 0 12 13 0 6 6 14 19 13 5 0 5
13 0 0 7 0 12 13 0 0 14 15 0 24 7 24 24 24 7 24 0 0 3 6 39 38 39 6 3 0 14 15 14 15 14 19 13 5 5 0 0
15 0 0 0 0 0 0 0 14 19 13 0 24 24 7 7 7 24 24 3 3 3 3 3 3 3 3 3 0 12 18 19 18 19 13 0 0 0 0 5
18 15 14 15 0 0 0 14 19 18 15 0 24 24 24 24 24 24 24 0 0 0 0 0 0 0 0 0 0 14 19 18 19 18 15 0 5 5 5 5
12 13 12 13 5 5 5 12 13 12 13 0 0 0 0 0 0 0 0 0 5 5 5 5 5 5 5 5 5 12 13 12 13 12 13 0 5 5 5 5
3 3 28 29 30 5 0 0 0 0 0 0 20 20 20 20 20 20 20 0 5 5 5 5 5 5 5 5 5 14 15 5 5 5 5 0 5 5 5 5
0 3 31 32 33 37 7 0 0 0 0 0 20 5 5 5 5 14 15 5 5 5 6 6 6 6 6 6 5 12 13 5 14 44 15 0 14 15 5 5
0 3 39 38 39 38 20 5 0 0 0 7 20 5 37 37 37 12 13 5 5 5 6 6 6 6 6 6 5 14 15 0 12 77 13 0 12 13 5 5
0 3 3 3 22 5 5 5 5 0 0 0 20 5 39 38 39 5 20 0 5 5 6 6 6 6 6 6 5 12 13 7 0 0 25 0 5 5 70 59
0 0 7 5 5 5 5 5 0 0 0 0 20 5 5 3 5 5 20 0 5 5 6 6 6 6 6 6 5 14 15 5 0 0 7 5 5 5 14 15
3 3 0 0 0 0 0 0 7 0 0 0 20 20 20 3 20 20 20 0 5 5 6 6 6 6 6 6 5 12 13 5 5 5 5 5 5 5 12 13
15 3 3 3 3 3 3 3 3 3 3 3 3 3 3 3 0 0 0 0 5 5 5 5 5 5 5 5 5 14 15 5 5 5 5 5 5 5 14 15
13 0 0 0 0 0 0 7 0 0 0 0 0 0 0 0 0 7 0 0 5 5 5 5 5 5 5 5 5 12 13 5 5 5 5 5 5 5 12 13
15 0 0 7 0 0 0 0 0 0 0 0 24 24 24 24 24 24 24 0 0 0 0 0 6 6 6 0 58 59 60 5 5 5 5 5 5 5 14 15
13 21 1 1 1 1 1 21 0 0 7 0 24 26 26 26 26 26 24 0 0 0 0 6 28 29 30 6 61 2 62 5 5 5 5 5 10 5 12 13
15 1 5 28 29 30 5 1 0 7 0 0 24 26 14 44 15 26 24 0 0 0 0 6 34 35 36 6 61 2 62 5 5 5 5 10 10 10 14 15
13 0 5 31 32 33 5 0 0 0 0 0 24 26 12 77 13 26 24 0 0 7 0 6 39 38 39 6 61 2 62 5 5 14 15 25 10 10 12 13
15 0 5 39 38 39 5 0 0 0 0 0 24 26 26 26 26 26 24 0 0 0 0 6 0 0 0 6 61 2 62 14 15 12 13 5 5 10 14 15
18 15 0 0 0 0 0 0 7 0 0 7 24 24 24 24 24 24 24 0 0 0 0 0 6 6 14 15 61 2 62 12 18 15 5 5 5 5 12 13
19 18 15 14 15 14 15 14 15 14 15 14 15 14 15 14 15 14 15 14 15 14 15 14 15 14 19 13 63 64 65 14 19 13 5 5 5 5 14 15
13 12 13 12 13 12 13 12 13 12 13 12 13 12 13 12 13 12 13 12 13 12 13 12 13 12 18 15 14 15 14 19 18 15 5 5 5 5 12 13